1111111111111
10C10000000C1
1000000000001
1000000000001
1000000000001
1000000000001
1P0E00C000001
1111111111111