11111111111111
10C100000000C1
10000000000001
10000000000001
10000000000001
10000000000111
1P0E00C0000101
11111111111111