11111111111111
10010000000001
10000000000001
10000000000001
10000000000001
10000000000111
1P0E00C0000101
11111111111111