11111111111111
10C100000000C1
10000000000001
10000000000001
10000000000001
10101110000111
1P1E1C00000101
11111111111111