11111111111111
1CCCCCCCCCCCC1
1CCCCPECCCCCC1
1CCCCCCCCCCCC1
11111111111111