11111111111111111
11FFF00000S=00011
11111111111111111