1111111111111111
100E0000E00P00C1
1111111111111111