11111111111111111
10000P000P000C0E1
11111111111111111