111111111111
1000PE000001
111111111111