111111111111
10000P000C01
111111111111