111111111111
10C0000E0001
111111111111