1111111111111111111111111111
1E1000000000000000000000PC11
1111111111111111111111111111