11111111111111111111111111
1CCC1000000000000P00000001
11111000E00000000000000001
11111111111111111111111111