1111111111111111
100P00C00E0000001
111111111111111111