1111111111111111
1000P00E00C00000
1111111111111111